-8
-4
9
4
000000000000000000
000000000011111110
000000010011111110
000110000011111110
000000000011111110
000010000011111110
000000000011111110
100000000011111110
000000001000000000
